12 19 3
src/bmp/map/ground.bmp
src/bmp/map/wall.bmp
src/bmp/map/water.bmp
01 01 01 01 01 01 01 01 01 01 01 01 01 01 01 01 01 01 01
00 00 00 00 00 00 00 01 00 00 00 00 00 00 00 00 00 00 01
01 01 01 01 01 00 00 01 00 00 01 01 01 01 00 00 00 00 01
01 00 00 00 01 00 00 00 00 00 01 02 02 01 00 00 00 00 01
01 00 00 00 01 00 00 00 00 00 01 02 02 01 00 00 00 00 01
01 00 00 00 01 00 00 01 00 00 01 01 01 01 00 00 00 00 01
01 00 00 00 00 00 00 01 00 00 01 00 00 01 00 00 00 00 01
01 00 00 00 00 00 00 01 00 00 00 00 00 00 00 00 00 00 01
01 00 00 00 01 00 00 01 01 01 01 01 01 00 00 01 01 01 01
01 00 00 00 01 00 00 01 00 00 00 00 00 00 00 00 00 00 01
01 00 00 00 01 00 00 01 00 00 00 00 00 00 00 00 00 00 01
01 01 01 01 01 01 01 01 01 01 01 01 01 01 01 01 01 01 01
