// NOVO TEMPLATE
[tile]
    id: "" src: "src/asset/png/tileset/10.png"

[collision]
    id: "0" label: "ground" src: "src/asset/png/tileset/00.png"
    id: "#" label: "wall"   src: "src/asset/png/tileset/01.png"
    id: "b" label: "block"  src: "src/asset/png/tileset/01.png"
    id: "1" label: "pipe 1" src: "src/asset/png/tileset/20.png"
    id: "2" label: "pipe 2" src: "src/asset/png/tileset/21.png"
    id: "3" label: "pipe 3" src: "src/asset/png/tileset/22.png"
    id: "4" label: "pipe 4" src: "src/asset/png/tileset/23.png"


[especial]
    id: "?" label: "box"    src: "src/asset/png/tileset/02.png" 
    id: "*" label: "coin"   src: "src/asset/png/tileset/03.png"


[map]

[part 00] 

..........................................................................
...................................*.*....................................
..................................*****...................................
..................................#####......................bbbbbb.......
............................................................bbbbbbb.......
..............*..*.........................................bbbbbbbb.......
.............#?##?#........#####..........................bbbbbbbbb.......
.........................................................bbbbbbbbbb.......
........................................................bbbbbbbbbbb.......
00000000000000000000000000000000000000000000000000000000000000000000000000
00000000000000000000000000000000000000000000000000000000000000000000000000

[part 01]

..........................................................................
..........................................................................
...................####################...................................
.............#######******************#..........########.................
...................#******************#.........................#?........
.........b.........############..######......???..........................
........bbb............................................................12.
.......bbbbb...........................12.......................12.....34.
......bbbbbbb..........................34..............12..***..34.***.34.
00000000000000000000000000000000000000000000000000000000000000000000000000
00000000000000000000000000000000000000000000000000000000000000000000000000

[part 02]

..........................................................................
..........................................................................
..........................................................................
..........................................................................
..........................................................................
............................####.####...###.#######.......................
....12....................................................................
....34....................................................................
....34....................................................................
000000...0000000000000.....................................000000000000000
000000...0000000000000.....................................000000000000000

[part 03]

..........................................................................
..........................................................................
..........................................................................
..........*******..............*..........................................
..........................................................................
......bbbbbbbbbbbbbbb.......*.....*.......................................
..........................................................................
.......................bbbbbbbbbbbbbbbb...................................
...............................................*******....................
............................................bbbbbbbbbbbbb.................
................................................................0000000000
